Date,Description,Debit,Credit,Balance
2024-12-28,pocket money,0.0,500.0,500.0
2024-12-29,Grab,10.0,0.0,490.0
2025-01-06,Dinner,10.0,0.0,480.0
2025-01-06,From Husbend,0.0,100.0,580.0
2025-01-07,salary,10000.0,0.0,10580.0
2025-01-07,Lunch,0.0,10.0,10570.0
