Date,Description,Debit,Credit,Balance
2025-01-16,pocket money,200.0,0.0,200.0
2025-01-16,eat,0.0,20.0,180.0
2025-01-16,food,50.0,0.0,230.0
2025-01-16,Added to savings,0.0,2.5,227.5
2025-01-16,Loan disbursement,1000.0,0.0,1227.5
2025-01-16,Added to savings,0.0,50.0,1177.5
